00000000000000002103
00000000000000000101
00000011111111000100
00000000000000000000
00000000020000011110
00000000110000000010
10000000000000000010
00000000000001100010
00000001100000000010
01100000000000000010
00000000000000000110
00000000000000000010
00000000000110000010
00000200000000000010
00000110000000000210
00000000000000000010
00000000000000000010
01100000000000000010
00011111111111111110
30000000000000000002