20000000000000021003
00000000000000001011
00000000000000001000
10000000000000001000
00000001111110001100
00000000000010001000
00111000000010001200
00000000000010011001
00000000000010001000
00000000111010001000
00000000000011001010
00000000000010001000
00011111111110001000
00000000000010101100
00000000000010001000
10000000000010001001
11111111100010001000
20000000000010001100
00000000000010001000
30000000000110000001