20000000000000000003
00000000000111111111
00000000001000000002
00000000010000000000
01110000100000000000
00000001000000000000
00000010000011100000
00000100000000000000
01111000000000000111
00000000000000000000
00000000000000000000
11111111100111111111
00000000000000000000
00000000000000000000
01111111111111111111
00000000000000000000
00000000000000000000
11011111111111111110
00012000000000000000
30010000000000000000